   180   150W  120W  90W   60W   30W   000   30E   60E   90E   120E  150E  180
    |     |     |     |     |     |     |     |     |     |     |     |     |
90N-+-----+-----+-----+-----+-----+-----+-----+-----+-----+-----+-----+-----+-90N
    |           . _..::__:  ,-"-"._        |7       ,     _,.__             |
    |   _.___ _ _<_>`!(._`.`-.    /         _._     `_ ,_/  '  '-._.---.-.__|
    |>.{     " " `-==,',._\{  \  / {)      / _ ">_,-' `                mt-2_|
60N-+  \_.:--.       `._ )`^-. "'       , [_/(                       __,/-' +-60N
    | '"'     \         "    _L        oD_,--'                )     /. (|   |
    |          |           ,'          _)_.\\._<> 6              _,' /  '   |
    |          `.         /           [_/_'` `"(                <'}  )      |
30N-+           \\    .-. )           /   `-'"..' `:._          _)  '       +-30N
    |    `        \  (  `(           /         `:\  > \  ,-^.  /' '         |
    |              `._,   ""         |           \`'   \|   ?_)  {\         |
    |                 `=.---.        `._._       ,'     "`  |' ,- '.        |
000-+                   |    `-._         |     /          `:`<_|h--._      +-000
    |                   (        >        .     | ,          `=.__.`-'\     |
    |                    `.     /         |     |{|              ,-.,\     .|
    |                     |   ,'           \   / `'            ,"     \     |
30S-+                     |  /              |_'                |  __  /     +-30S
    |                     | |                                  '-'  `-'   \.|
    |                     |/                                         "    / |
    |                     \.                                             '  |
60S-+                                                                       +-60S
    |                      ,/            ______._.--._ _..---.---------._   |
    |     ,-----"-..?----_/ )      __,-'"             "                  (  |
    |-.._(                  `-----'                                       `-|
90S-+-----+-----+-----+-----+-----+-----+-----+-----+-----+-----+-----+-----+-90S
    |     |     |     |     |     |     |     |     |     |     |     |     |
   180   150W  120W  90W   60W   30W   000   30E   60E   90E   120E  150E  180
     -----+-----+-----+-----+-----+-----+-----+-----+-----+-----+-----+-----
Matthew Thomas 1998
